 room_type_id | reservations_count 
--------------+--------------------
            1 |                103
            2 |                171
            3 |                230
            4 |                218
            5 |                250
            6 |                213
            7 |                126
            8 |                249
            9 |                166
(9 rows)

