 room_type_id | room_count 
--------------+------------
            1 |          8
            2 |         12
            3 |         11
            4 |         12
            5 |          9
            6 |         22
            7 |         14
            8 |         12
            9 |         15
(9 rows)

